A : Id
B : ListingFee
C : AvitoId
D : ManagerName
E : ContactPhone
F : ImageUrls
G : Address
H : ContactMethod
I : Category
J : Industry
K : Title
L : EmploymentType
M : JobType
N : WorkingDaysPerWeek
O : WorkingDaysPerDay
P : Experience
Q : Description
R : SalaryRange
S : PayPeriod
T : PayoutFrequency
U : Tax
V : JobBonuses
W : Profession
X : AgePreferences
Y : PartTimeJob
Z : RegistrationMethod
AA : ApplyType
AB : AgeCriteria
AC : CitizenshipCriteria
AD : MedicalBook
AE : FoodProductionShopType
AF : RetailEquipmentType
AG : EateryType
AH : RetailShopType
AI : Cuisine
AJ : CleaningJobSiteType
AK : VacancyCode
AL : ThereIsSalary
AM : AskAge
AN : EMail
AO : ChatQuestionnaire
AP : CompanyName
AQ : AvitoDateEnd
AR : Price
AS : AskCitizenship
AT : AvitoStatus
AU : AIRecruter
